filename,start,end,duration,time_extract-data,time_core-phrases,time_keywords,time_stats,time_guess-language,time_merger
draft-akiya-mpls-lsp-ping-lag-multipath-00.pdf,1577367681,1577369194,1513,1411,74,75,41,35,24
draft-campbell-tokbind-tls-term-00.pdf,1577367680,1577369466,1786,840,841,634,829,502,102
draft-capelastegui-mmusic-3dv-sdp-00.pdf,1577367676,1577369468,1792,660,1107,952,943,935,20
draft-akiya-bfd-seamless-alert-discrim-02.pdf,1577367678,1577369473,1795,598,953,1011,1171,746,23
draft-aliahmad-dmm-anchor-selection-00.pdf,1577367675,1577369490,1815,323,1164,1400,1178,968,90
draft-castellani-core-http-mapping-01.pdf,1577367676,1577369546,1870,623,1243,1099,1018,1214,
draft-am-bfd-performance-00.pdf,1577367675,1577369597,1922,349,1540,1488,1193,1077,29
draft-akiya-bfd-seamless-base-00.pdf,1577367673,1577369625,1952,1138,425,448,754,397,55
draft-campbell-oauth-mtls-01.pdf,1577367683,1577369638,1955,924,619,1000,372,366,27
draft-antti-rfc2806bis-06.pdf,1577367681,1577369707,2026,1069,319,442,359,917,36
draft-akiya-bfd-seamless-sr-00.pdf,1577367675,1577369754,2079,434,1360,1557,1394,894,87
draft-aliahmad-dmm-anchor-selection-01.pdf,1577367679,1577369803,2124,664,1332,982,935,1441,16
draft-ali-pce-remote-initiated-gmpls-lsp-00.pdf,1577367679,1577369853,2174,1054,1102,361,967,634,15
draft-akiya-bfd-seamless-ip-03.pdf,1577367682,1577369856,2174,1252,82,220,432,238,486
draft-akiya-mpls-lsp-ping-reply-mode-simple-03.pdf,1577367677,1577369868,2191,462,1384,1467,1696,1096,28
draft-akiya-bfd-seamless-alert-discrim-00.pdf,1577367678,1577369886,2208,733,1029,895,1000,1423,47
draft-akiya-bfd-seamless-alert-discrim-01.pdf,1577367673,1577369889,2216,1069,301,1114,333,371,29
draft-akiya-mpls-lsp-ping-reply-mode-simple-01.pdf,1577367682,1577369905,2223,910,772,350,344,1285,24
draft-akiya-mpls-lsp-ping-reply-mode-simple-02.pdf,1577367673,1577369912,2239,982,1053,1128,429,1211,36
draft-campbell-oauth-resource-indicators-00.pdf,1577367677,1577369940,2263,1241,443,168,104,988,30
draft-akiya-mpls-entropy-lsp-ping-00.pdf,1577367677,1577369964,2287,466,1230,1801,1458,1478,16
draft-akiya-bfd-seamless-sr-03.pdf,1577367674,1577369975,2301,307,1454,1327,993,1777,212
draft-akiya-mpls-entropy-lsp-ping-02.pdf,1577367672,1577369981,2309,188,1914,1202,1117,1838,204
draft-akiya-mpls-lsp-ping-lag-multipath-02.pdf,1577367672,1577369984,2312,180,1490,1440,1921,1785,207
draft-alvestrand-rmcat-congestion-03.pdf,1577367673,1577370007,2334,1223,727,859,73,311,249
draft-akiya-bfd-seamless-alert-discrim-03.pdf,1577367683,1577370038,2355,2192,114,130,67,90,30
draft-ali-pce-remote-initiated-gmpls-lsp-02.pdf,1577367672,1577370046,2374,227,1995,2124,1662,1613,17
draft-ali-pce-remote-initiated-lsp-usage-00.pdf,1577367672,1577370089,2417,178,1848,1679,1885,2083,152
draft-akiya-bfd-seamless-sr-02.pdf,1577367679,1577370119,2440,783,1055,1610,972,1584,42
draft-akiya-mpls-lsp-ping-lag-multipath-04.pdf,1577367678,1577370121,2443,1245,542,1158,1102,1162,32
draft-akiya-bfd-seamless-base-02.pdf,1577367680,1577370141,2461,2043,318,377,103,64,38
draft-akiya-mpls-entropy-lsp-ping-04.pdf,1577367676,1577370150,2474,518,1267,1931,1365,1636,21
draft-carey-core-std-msg-vs-trans-adapt-00.pdf,1577367674,1577370162,2488,316,1399,1944,2154,1686,14
draft-akiya-bfd-seamless-ip-04.pdf,1577367682,1577370302,2620,2341,154,136,97,106,121
draft-akiya-bfd-seamless-ip-00.pdf,1577367673,1577370309,2636,2502,102,111,50,42,20
draft-akiya-bfd-seamless-sr-01.pdf,1577367679,1577371348,3669,2899,769,559,534,687,
draft-campbell-oauth-sts-02.pdf,1577367676,1577371485,3809,3102,677,504,610,676,25
draft-akiya-mpls-lsp-ping-lag-multipath-01.pdf,1577367673,1577371557,3884,3268,543,307,412,323,69
draft-am-dprive-eval-01.pdf,1577367679,1577371572,3893,2882,936,567,845,523,71
draft-akiya-bfd-seamless-ip-05.pdf,1577367673,1577371607,3934,3269,59,54,47,44,602
draft-campbell-oauth-mtls-00.pdf,1577367680,1577371636,3956,2700,1183,665,922,647,68
draft-campbell-oauth-sts-00.pdf,1577367680,1577371650,3970,3228,310,619,307,708,30
draft-carney-regext-validate-00.pdf,1577367680,1577371664,3984,3103,449,612,839,497,37
draft-alcaide-calabria-idr-bgp-prefix-priority-00.pdf,1577367681,1577371696,4015,2930,1025,560,810,889,55
draft-akiya-mpls-lsp-ping-lag-multipath-03.pdf,1577367681,1577371724,4043,2714,661,662,684,825,499
draft-ama-mpls-fm-rdi-00.pdf,1577367674,1577371725,4051,3821,167,198,161,73,27
draft-akiya-mpls-entropy-lsp-ping-03.pdf,1577367680,1577371752,4072,3274,287,739,587,562,56
draft-alexander-roll-mikey-lln-key-mgmt-01.pdf,1577367679,1577371754,4075,2766,923,879,1257,886,47
draft-adamson-elasticmcast-00.pdf,1577367678,1577371772,4094,3088,694,816,560,762,185
draft-akiya-mpls-lsp-ping-lag-multipath-05.pdf,1577367683,1577371786,4103,3478,586,246,236,599,22
draft-aazam-cdni-inter-cloud-architecture-00.pdf,1577367681,1577371811,4130,3606,321,493,422,316,27
draft-agarwal-intarea-mams-protocol-json-00.pdf,1577367681,1577371834,4153,2962,527,1187,527,828,
draft-ali-pce-remote-initiated-gmpls-lsp-01.pdf,1577367675,1577372418,4743,4225,458,339,475,313,40
draft-castellani-core-http-mapping-03.pdf,1577367678,1577372418,4740,4630,106,56,50,47,
draft-aayadi-6lowpan-tcphc-01.pdf,1577367672,1577372433,4761,4472,170,210,153,114,76
draft-akiya-mpls-entropy-lsp-ping-01.pdf,1577367683,1577372478,4795,4268,504,273,268,415,21
draft-akiya-bfd-seamless-ip-02.pdf,1577367682,1577372499,4817,4214,583,323,316,515,17
draft-campbell-oauth-sts-01.pdf,1577367676,1577372504,4828,4494,295,315,251,241,15
draft-campbell-oauth-resource-indicators-01.pdf,1577367674,1577372505,4831,4476,228,333,146,142,17
draft-akiya-mpls-lsp-ping-reply-mode-simple-00.pdf,1577367677,1577372505,4828,4358,450,269,386,395,17
